original	reordered
Pianko Adam	Adam Pianko
Christie Agatha	Agatha Christie
Natanson Agathe	Agathe Natanson
Jaoui Agnès	Agnès Jaoui
Barroux Alain	Alain Barroux
Beach Alain	Alain Beach
Bernier Alain	Alain Bernier
Bertheau Alain	Alain Bertheau
Bouvette Alain	Alain Bouvette
Duclos Alain	Alain Duclos
Franck Alain	Alain Franck
Ganas Alain	Alain Ganas
Krief Alain	Alain Krief
Robak Alain	Alain Robak
Vandamme Alain	Alain Vandamme
Gercourt Albert	Albert Gercourt
Médina Albert	Albert Médina
Pecker Alexandra	Alexandra Pecker
Arnoux Alexandre	Alexandre Arnoux
Klimenko Alexandre	Alexandre Klimenko
Rivemale Alexandre	Alexandre Rivemale
Delacour Alfred	Alfred Delacour
Sapritch Alice	Alice Sapritch
Tissot Alice	Alice Tissot
Bertrand Aline	Aline Bertrand
Bonnardel André	André Bonnardel
Burgère André	André Burgère
Buroche André	André Buroche
Cellier André	André Cellier
Delaure André	André Delaure
Falcon André	André Falcon
Fernez André	André Fernez
Gilles André	André Gilles
Helena André	André Helena
Lambert André	André Lambert
Lesage André	André Lesage
Oumansky André	André Oumansky
Picot André	André Picot
Reybaz André	André Reybaz
Rouland André	André Rouland
Thorent André	André Thorent
Valmy André	André Valmy
Var André	André Var
Villard André	André Villard
Wasley André	André Wasley
Laberty Andrée	Andrée Laberty
Tainsy Andrée	Andrée Tainsy
Bastiani Ange	Ange Bastiani
Beaucaire Ange	Ange Beaucaire
Gilles Ange	Ange Gilles
Gaylor Anna	Anna Gaylor
Alexandre Anne	Anne Alexandre
Amado Anne	Anne Amado
Caprile Anne	Anne Caprile
Deleuze Anne	Anne Deleuze
Doat Anne	Anne Doat
Fournet Anne	Anne Fournet
Gabory Anne	Anne Gabory
Kerylen Anne	Anne Kerylen
Perez Anne	Anne Perez
Rochant Anne	Anne Rochant
Rousselet Anne	Anne Rousselet
Wartel Anne	Anne Wartel
Poivre Annette	Annette Poivre
Allières Annick	Annick Allières
Bertho Annick	Annick Bertho
Blancheteau Annick	Annick Blancheteau
Fougery Annick	Annick Fougery
Korrigan Annick	Annick Korrigan
Bertin Annie	Annie Bertin
Dana Annie	Annie Dana
Ducaux Annie	Annie Ducaux
Fargue Annie	Annie Fargue
Girardot Annie	Annie Girardot
Mercier Annie	Annie Mercier
Roudier Annie	Annie Roudier
Romand Anny	Anny Romand
Ferjac Anouk	Anouk Ferjac
Dulery Antoine	Antoine Dulery
Marin Antoine	Antoine Marin
Moya Antoinette	Antoinette Moya
Stuart Antony	Antony Stuart
Muratore Ariane	Ariane Muratore
Accart Arlette	Arlette Accart
Josselin Arlette	Arlette Josselin
Merry Arlette	Arlette Merry
Thomas Arlette	Arlette Thomas
Lanoux Armand	Armand Lanoux
Meffre Armand	Armand Meffre
Bedouët Arnaud	Arnaud Bedouët
Teneze Arnaud	Arnaud Teneze
Rosanes Becky	Becky Rosanes
Guibert Benoît	Benoît Guibert
Dautun Bérengère	Bérengère Dautun
Lange Bernadette	Bernadette Lange
Dhéran Bernard	Bernard Dhéran
Dumaine Bernard	Bernard Dumaine
Fresson Bernard	Bernard Fresson
Granger Bernard	Bernard Granger
Hubrenne Bernard	Bernard Hubrenne
Latour Bernard	Bernard Latour
Lavalette Bernard	Bernard Lavalette
Leroux Bernard	Bernard Leroux
Menez Bernard	Bernard Menez
Murat Bernard	Bernard Murat
Musson Bernard	Bernard Musson
Noël Bernard	Bernard Noël
Plantey Bernard	Bernard Plantey
Saxel Bernard	Bernard Saxel
Valdeneige Bernard	Bernard Valdeneige
Veron Bernard	Bernard Veron
Bovy Berthe	Berthe Bovy
Chernel Berthe	Berthe Chernel
Liebert Bertrand	Bertrand Liebert
Auber Brigitte	Brigitte Auber
Bellac Brigitte	Brigitte Bellac
Winstel Brigitte	Brigitte Winstel
Horowicz Bronislaw	Bronislaw Horowicz
Allain Bruno	Bruno Allain
Balp Bruno	Bruno Balp
Dega Bruno	Bruno Dega
Devoldère Bruno	Bruno Devoldère
Fischer Bruno	Bruno Fischer
Léandri Bruno	Bruno Léandri
Masquelin Bruno	Bruno Masquelin
Richy Bruno	Bruno Richy
Cellier Caroline	Caroline Cellier
Clerc Caroline	Caroline Clerc
Jacquin Caroline	Caroline Jacquin
Arditi Catherine	Catherine Arditi
Dutrillo Catherine	Catherine Dutrillo
Erard Catherine	Catherine Erard
Grello Catherine	Catherine Grello
Hiegel Catherine	Catherine Hiegel
Hubeau Catherine	Catherine Hubeau
Laborde Catherine	Catherine Laborde
Salviat Catherine	Catherine Salviat
Sauvage Catherine	Catherine Sauvage
Sellers Catherine	Catherine Sellers
Watteau Catherine	Catherine Watteau
Crovi Chantal	Chantal Crovi
Lavallée Chantal	Chantal Lavallée
Pommier Chantal	Chantal Pommier
Vivier Chantal	Chantal Vivier
Bassompierre Charles	Charles Bassompierre
Charras Charles	Charles Charras
Dickens Charles	Charles Dickens
Esquier Charles	Charles Esquier
Exbrayat Charles	Charles Exbrayat
Maitre Charles	Charles Maitre
Armstrong Charlotte	Charlotte Armstrong
Clasis Charlotte	Charlotte Clasis
Alers Christian	Christian Alers
Baltauss Christian	Christian Baltauss
Daumas Christian	Christian Daumas
Dumas Christian	Christian Dumas
Fourcade Christian	Christian Fourcade
Riehl Christian	Christian Riehl
Zanetti Christian	Christian Zanetti
Barry Christiane	Christiane Barry
Carpentier Christiane	Christiane Carpentier
Lamorlette Christiane	Christiane Lamorlette
Lasquin Christiane	Christiane Lasquin
Regnault Christiane	Christiane Regnault
Verger Christiane	Christiane Verger
Ehm Christine	Christine Ehm
Ellsen Christine	Christine Ellsen
Elsen Christine	Christine Elsen
Fabrega Christine	Christine Fabrega
Lauzanne Christine	Christine Lauzanne
Melcer Christine	Christine Melcer
Sandre Christine	Christine Sandre
Arleston Christophe	Christophe Arleston
Labaude Chrystelle	Chrystelle Labaude
Magnin Claire	Claire Magnin
Maurier Claire	Claire Maurier
Olivier Claire	Claire Olivier
Vernet Claire	Claire Vernet
Viret Claire	Claire Viret
Lernout Clarisse	Clarisse Lernout
Aveline Claude	Claude Aveline
Beauclair Claude	Claude Beauclair
Bertrand Claude	Claude Bertrand
Brosset Claude	Claude Brosset
Bruna Claude	Claude Bruna
Dasset Claude	Claude Dasset
Dauphin Claude	Claude Dauphin
Dufresne Claude	Claude Dufresne
Ecken Claude	Claude Ecken
Garbe Claude	Claude Garbe
Genia Claude	Claude Genia
Gensac Claude	Claude Gensac
Gevel Claude	Claude Gevel
Gregory Claude	Claude Gregory
Herval Claude	Claude Herval
Leblond Claude	Claude Leblond
Ligonie Claude	Claude Ligonie
Marquie Claude	Claude Marquie
Martin Claude	Claude Martin
Morin Claude	Claude Morin
Nicot Claude	Claude Nicot
Nollier Claude	Claude Nollier
Orval Claude	Claude Orval
Pasquier Claude	Claude Pasquier
Piéplu Claude	Claude Piéplu
Rich Claude	Claude Rich
Richard Claude	Claude Richard
Rollet Claude	Claude Rollet
Vadel Claude	Claude Vadel
Vernier Claude	Claude Vernier
Berg Claudine	Claudine Berg
Cheret Claudine	Claudine Cheret
Coster Claudine	Claudine Coster
Bairam Clément	Clément Bairam
Castel Colette	Colette Castel
Richard Colette	Colette Richard
Ripert Colette	Colette Ripert
Teissedre Colette	Colette Teissedre
Robertson Colin	Colin Robertson
Thibert Colin	Colin Thibert
Marchand Corinne	Corinne Marchand
Bremont Daniel	Daniel Bremont
Colas Daniel	Daniel Colas
Emilfork Daniel	Daniel Emilfork
Gall Daniel	Daniel Gall
Ivernel Daniel	Daniel Ivernel
Lebrun Daniel	Daniel Lebrun
Toursière Daniel	Daniel Toursière
Viciana Daniel	Daniel Viciana
Ajoret Danièle	Danièle Ajoret
Delorme Danièle	Danièle Delorme
Lebrun Danièle	Danièle Lebrun
Volle Danielle	Danielle Volle
Stratford Davis	Davis Stratford
Daniel Denis	Denis Daniel
Diderot Denis	Denis Diderot
Manuel Denis	Denis Manuel
Savignat Denis	Denis Savignat
Benoit Denise	Denise Benoit
Bosc Denise	Denise Bosc
Gence Denise	Denise Gence
Gens Denise	Denise Gens
Grey Denise	Denise Grey
Montreal Denise	Denise Montreal
Blonay Didier	Didier Blonay
Conti Didier	Didier Conti
Haudepin Didier	Didier Haudepin
Rousset Didier	Didier Rousset
Aubert Dominique	Dominique Aubert
Bailly Dominique	Dominique Bailly
Buckardt Dominique	Dominique Buckardt
Davray Dominique	Dominique Davray
Foufelle Dominique	Dominique Foufelle
Jayr Dominique	Dominique Jayr
Page Dominique	Dominique Page
Paquet Dominique	Dominique Paquet
Paturel Dominique	Dominique Paturel
Tirmont Dominique	Dominique Tirmont
Vincent Dominique	Dominique Vincent
Doll Dora	Dora Doll
Sayers Dorothy	Dorothy Sayers
Babet Doudou	Doudou Babet
Ky Duyen	Duyen Ky
Loria Edith	Edith Loria
Scob Edith	Edith Scob
Ardisson Edmond	Edmond Ardisson
Constans Edmond	Edmond Constans
Liorel Edmond	Edmond Liorel
Tamiz Edmond	Edmond Tamiz
Sherry Edna	Edna Sherry
Estaunie Edouard	Edouard Estaunie
Lanham Edwin	Edwin Lanham
Moatti Edwine	Edwine Moatti
Maingot Eliane	Eliane Maingot
Berthet Elie	Elie Berthet
Gentet Elisabeth	Elisabeth Gentet
Salvaresi Elisabeth	Elisabeth Salvaresi
Damia Ema	Ema Damia
Gaboriau Emile	Emile Gaboriau
Riandreys Emile	Emile Riandreys
Ciepka Emmanuel	Emmanuel Ciepka
Assous Eric	Eric Assous
Colin Eric	Eric Colin
Legrand Eric	Eric Legrand
Peter Eric	Eric Peter
Bierry Etienne	Etienne Bierry
Moreau Eugène	Eugène Moreau
Sue Eugène	Eugène Sue
Darlan Eva	Eva Darlan
Griliquez Eve	Eve Griliquez
Séléna Evelyn	Evelyn Séléna
Dandry Evelyne	Evelyne Dandry
Dress Evelyne	Evelyne Dress
Frémy Evelyne	Evelyne Frémy
Gabrielli Evelyne	Evelyne Gabrielli
Ker Evelyne	Evelyne Ker
Kerr Evelyne	Evelyne Kerr
Langey Evelyne	Evelyne Langey
Robiane Fanny	Fanny Robiane
Rauzena Fernand	Fernand Rauzena
Sardou Fernand	Fernand Sardou
Walter Fiamma	Fiamma Walter
Fitzgerald Flore	Flore Fitzgerald
Blot Florence	Florence Blot
Brière Florence	Florence Brière
Prévost Floriane	Floriane Prévost
Delahalle France	France Delahalle
Descaut France	France Descaut
Marie France-chanteuse	France-chanteuse Marie
Vernillat Francette	Francette Vernillat
Bergé Francine	Francine Bergé
Laine Francine	Francine Laine
Crémieux Francis	Francis Crémieux
Didelot Francis	Francis Didelot
Geraud Francis	Francis Geraud
Capillery Franck	Franck Capillery
Barluet François	François Barluet
Billetdoux François	François Billetdoux
Chaumette François	François Chaumette
Chevais François	François Chevais
Chodat François	François Chodat
Darbon François	François Darbon
Gamard François	François Gamard
Maistre François	François Maistre
Marthouret François	François Marthouret
Morel François	François Morel
Nocher François	François Nocher
Périer François	François Périer
Rémy François	François Rémy
Tarrancle François	François Tarrancle
Timmory François	François Timmory
Vibert François	François Vibert
Cingal Françoise	Françoise Cingal
Dasque Françoise	Françoise Dasque
Fabian Françoise	Françoise Fabian
Faure Françoise	Françoise Faure
Favier Françoise	Françoise Favier
Fechter Françoise	Françoise Fechter
Fouquet Françoise	Françoise Fouquet
Hornez Françoise	Françoise Hornez
Jacquet Françoise	Françoise Jacquet
Jacquier Françoise	Françoise Jacquier
Rosay Françoise	Françoise Rosay
Soulié Françoise	Françoise Soulié
Vatel Françoise	Françoise Vatel
Fisher Fred	Fred Fisher
Kassak Fred	Fred Kassak
Personne Fred	Fred Personne
Cerdal Frédéric	Frédéric Cerdal
Fabre Frédéric	Frédéric Fabre
Hoë Frédéric	Frédéric Hoë
Valmain Frédéric	Frédéric Valmain
Valmont Frédéric	Frédéric Valmont
Cantrel Frédérique	Frédérique Cantrel
Dürrenmatt Friedrich	Friedrich Dürrenmatt
Gobin Gabriel	Gabriel Gobin
Centanini Gabrielle	Gabrielle Centanini
Doulcet Gabrielle	Gabrielle Doulcet
Fontan Gabrielle	Gabrielle Fontan
Basset Gaby	Gaby Basset
Romande Gaëlle	Gaëlle Romande
Jor Gaétan	Gaétan Jor
Vacchia Gaston	Gaston Vacchia
Baroux Geneviève	Geneviève Baroux
Brunet Geneviève	Geneviève Brunet
Lacheze Geneviève	Geneviève Lacheze
Manceron Geneviève	Geneviève Manceron
Morel Geneviève	Geneviève Morel
Page Geneviève	Geneviève Page
Wallery Geo	Geo Wallery
Aminel Georges	Georges Aminel
Aubert Georges	Georges Aubert
Audoubert Georges	Georges Audoubert
Beauvilliers Georges	Georges Beauvilliers
Carmier Georges	Georges Carmier
Chamarat Georges	Georges Chamarat
Coste Georges	Georges Coste
Godebert Georges	Georges Godebert
Gravier Georges	Georges Gravier
Ohnet Georges	Georges Ohnet
Peyrou Georges	Georges Peyrou
Sellier Georges	Georges Sellier
Villemier Georges	Georges Villemier
Vittel Georges	Georges Vittel
Wilson Georges	Georges Wilson
Heyer Georgette	Georgette Heyer
Morales Gérald	Gérald Morales
Darrieu Gérard	Gérard Darrieu
Dournel Gérard	Gérard Dournel
Fallec Gérard	Gérard Fallec
Gervais Gérard	Gérard Gervais
Hespel Gérard	Gérard Hespel
Lartigau Gérard	Gérard Lartigau
Laureau Gérard	Gérard Laureau
Levoyer Gérard	Gérard Levoyer
Monetay Gérard	Gérard Monetay
Séty Gérard	Gérard Séty
Thirion Gérard	Gérard Thirion
Beaumont Germaine	Germaine Beaumont
Decrest Germaine	Germaine Decrest
Delbat Germaine	Germaine Delbat
Kerjean Germaine	Germaine Kerjean
Caseneuve Gilbert	Gilbert Caseneuve
Hédard Gilbert	Gilbert Hédard
Levy Gilbert	Gilbert Levy
Picard Gilbert	Gilbert Picard
Roussel Gilbert	Gilbert Roussel
Sigaux Gilbert	Gilbert Sigaux
Amado Gilles	Gilles Amado
Astorg Gilles	Gilles Astorg
Guillot Gilles	Gilles Guillot
Warga Gilles	Gilles Warga
Franck Ginette	Ginette Franck
Leclerc Ginette	Ginette Leclerc
Pigeon Ginette	Ginette Pigeon
Casadesus Gisèle	Gisèle Casadesus
Grimm Gisèle	Gisèle Grimm
Touret Gisèle	Gisèle Touret
Pascal Giselle	Giselle Pascal
Kergourlay Guillaume	Guillaume Kergourlay
Bousquet Guy	Guy Bousquet
Bréjac Guy	Guy Bréjac
Decomble Guy	Guy Decomble
Delaunay Guy	Guy Delaunay
Fau Guy	Guy Fau
Gentilhomme Guy	Guy Gentilhomme
Louvet Guy	Guy Louvet
Piérauld Guy	Guy Piérauld
Rotter Guy	Guy Rotter
Tréjan Guy	Guy Tréjan
Benglia Habib	Habib Benglia
Verner Hans	Hans Verner
Krimer Harry	Harry Krimer
Dieudonné Hélène	Hélène Dieudonné
Duc Hélène	Hélène Duc
Garaud Hélène	Hélène Garaud
Martin Hélène	Hélène Martin
Misserly Hélène	Hélène Misserly
Sauvaneix Hélène	Hélène Sauvaneix
Belli Henri	Henri Belli
Courseaux Henri	Henri Courseaux
Crémieux Henri	Henri Crémieux
Crespi Henri	Henri Crespi
Darbrey Henri	Henri Darbrey
Dassa Henri	Henri Dassa
Gilabert Henri	Henri Gilabert
Grangé Henri	Henri Grangé
Guisol Henri	Henri Guisol
Kubnick Henri	Henri Kubnick
Labussière Henri	Henri Labussière
Mitton Henri	Henri Mitton
Nassiet Henri	Henri Nassiet
Nova Henri	Henri Nova
Poirier Henri	Henri Poirier
Rollan Henri	Henri Rollan
Rolland Henri	Henri Rolland
Soubeyran Henri	Henri Soubeyran
Vilbert Henri	Henri Vilbert
Virlojeux Henri	Henri Virlojeux
Mcclelland Henriette	Henriette Mcclelland
Bordeaux Henry	Henry Bordeaux
Courseaux Henry	Henry Courseaux
Djanik Henry	Henry Djanik
Ojani Henry	Henry Ojani
Breuil Hervé	Hervé Breuil
Colombel Hervé	Hervé Colombel
Renault Herveline	Herveline Renault
Vernon Howard	Howard Vernon
Buthion Hubert	Hubert Buthion
Deschamps Hubert	Hubert Deschamps
Prelier Hubert	Hubert Prelier
Wheeler Hugh	Hugh Wheeler
Liese Hugues	Hugues Liese
Nazaris Inès	Inès Nazaris
Christian Irène	Irène Christian
Laurent Irène	Irène Laurent
Anderson Isabelle	Isabelle Anderson
Ehni Isabelle	Isabelle Ehni
Ganz Isabelle	Isabelle Ganz
Tanakil Isabelle	Isabelle Tanakil
Jaquine Jack	Jack Jaquine
Gencel Jacky	Jacky Gencel
Auclair Jacqueline	Jacqueline Auclair
Brasseur Jacqueline	Jacqueline Brasseur
Carrel Jacqueline	Jacqueline Carrel
Danno Jacqueline	Jacqueline Danno
Erly Jacqueline	Jacqueline Erly
Frot Jacqueline	Jacqueline Frot
Gauthier Jacqueline	Jacqueline Gauthier
Jefford Jacqueline	Jacqueline Jefford
Jehanneuf Jacqueline	Jacqueline Jehanneuf
Lefevre Jacqueline	Jacqueline Lefevre
Maillan Jacqueline	Jacqueline Maillan
Morane Jacqueline	Jacqueline Morane
Pierreux Jacqueline	Jacqueline Pierreux
Porel Jacqueline	Jacqueline Porel
Rivière Jacqueline	Jacqueline Rivière
Amyran Jacques	Jacques Amyran
Anquetil Jacques	Jacques Anquetil
Armand Jacques	Jacques Armand
Aveline Jacques	Jacques Aveline
Berger Jacques	Jacques Berger
Berthier Jacques	Jacques Berthier
Boisse Jacques	Jacques Boisse
Bonnaffé Jacques	Jacques Bonnaffé
Borel Jacques	Jacques Borel
Bouanich Jacques	Jacques Bouanich
Bretonnière Jacques	Jacques Bretonnière
Castelot Jacques	Jacques Castelot
Chabannes Jacques	Jacques Chabannes
Charby Jacques	Jacques Charby
Chardonnier Jacques	Jacques Chardonnier
Dacqmine Jacques	Jacques Dacqmine
Dancour Jacques	Jacques Dancour
Dannoville Jacques	Jacques Dannoville
Decrest Jacques	Jacques Decrest
Degor Jacques	Jacques Degor
Deschamps Jacques	Jacques Deschamps
Dublin Jacques	Jacques Dublin
Duby Jacques	Jacques Duby
Dufilho Jacques	Jacques Dufilho
Dumaine Jacques	Jacques Dumaine
Dynam Jacques	Jacques Dynam
Famery Jacques	Jacques Famery
Fayet Jacques	Jacques Fayet
Ferrière Jacques	Jacques Ferrière
Floran Jacques	Jacques Floran
Fonson Jacques	Jacques Fonson
Frantz Jacques	Jacques Frantz
Harden Jacques	Jacques Harden
Hébert Jacques	Jacques Hébert
Hilling Jacques	Jacques Hilling
Lassalle Jacques	Jacques Lassalle
Maire Jacques	Jacques Maire
Mancier Jacques	Jacques Mancier
Marin Jacques	Jacques Marin
Mauclair Jacques	Jacques Mauclair
Monod Jacques	Jacques Monod
Morel Jacques	Jacques Morel
Plee Jacques	Jacques Plee
Provins Jacques	Jacques Provins
Rispal Jacques	Jacques Rispal
Ruisseau Jacques	Jacques Ruisseau
Sapin Jacques	Jacques Sapin
Sarthou Jacques	Jacques Sarthou
Thébault Jacques	Jacques Thébault
Thibault Jacques	Jacques Thibault
Toja Jacques	Jacques Toja
Vincey Jacques	Jacques Vincey
Marken Jane	Jane Marken
Forney Janine	Janine Forney
Lehmann Javotte	Javotte Lehmann
Bellanger Jean	Jean Bellanger
Bergé Jean	Jean Bergé
Berger Jean	Jean Berger
Bériac Jean	Jean Bériac
Bolo Jean	Jean Bolo
Bommart Jean	Jean Bommart
Brassat Jean	Jean Brassat
Brochard Jean	Jean Brochard
Bruce Jean	Jean Bruce
Brunel Jean	Jean Brunel
Chatenet Jean	Jean Chatenet
Chevrier Jean	Jean Chevrier
Chevrin Jean	Jean Chevrin
Clarieux Jean	Jean Clarieux
Cosmos Jean	Jean Cosmos
Davy Jean	Jean Davy
Delanduc Jean	Jean Delanduc
Delhaye Jean	Jean Delhaye
Deloron Jean	Jean Deloron
Doat Jean	Jean Doat
Dorcino Jean	Jean Dorcino
Fontaine Jean	Jean Fontaine
Francey Jean	Jean Francey
Frapat Jean	Jean Frapat
Garretto Jean	Jean Garretto
Gastaut Jean	Jean Gastaut
Godet Jean	Jean Godet
Grimod Jean	Jean Grimod
Jusforgues Jean	Jean Jusforgues
Lagache Jean	Jean Lagache
Lemaitre Jean	Jean Lemaitre
Leuvrais Jean	Jean Leuvrais
Luc Jean	Jean Luc
Lullien Jean	Jean Lullien
Marchat Jean	Jean Marchat
Marcillac Jean	Jean Marcillac
Marconi Jean	Jean Marconi
Mathys Jean	Jean Mathys
Mauvais Jean	Jean Mauvais
Mercure Jean	Jean Mercure
Mourière Jean	Jean Mourière
Negroni Jean	Jean Negroni
Neuberth Jean	Jean Neuberth
Nickles Jean	Jean Nickles
Ozenne Jean	Jean Ozenne
Parédès Jean	Jean Parédès
Patrick Jean	Jean Patrick
Péméja Jean	Jean Péméja
Puyberneau Jean	Jean Puyberneau
Rochefort Jean	Jean Rochefort
Rougerie Jean	Jean Rougerie
Servais Jean	Jean Servais
Tissier Jean	Jean Tissier
Topart Jean	Jean Topart
Toscane Jean	Jean Toscane
Toulout Jean	Jean Toulout
Valton Jean	Jean Valton
Volmier Jean	Jean Volmier
Wall Jean	Jean Wall
Werner Jean	Jean Werner
Boitel Jeanne	Jeanne Boitel
Dorival Jeanne	Jeanne Dorival
Hardeyn Jeanne	Jeanne Hardeyn
Raylambert Jeannine	Jeannine Raylambert
Orléans Jenny	Jenny Orléans
Nobécourt Jérôme	Jérôme Nobécourt
Charrier Jo	Jo Charrier
Darche Jocelyne	Jocelyne Darche
Noel Joe	Joe Noel
Fossier Joëlle	Joëlle Fossier
Janin Joëlle	Joëlle Janin
Creasey John	John Creasey
Artur José	José Artur
Boulva Josette	Josette Boulva
Harmina Josette	Josette Harmina
Vardier Josette	Josette Vardier
Pinson Josiane	Josiane Pinson
Strelczyk Josiane	Josiane Strelczyk
Magre Judith	Judith Magre
Arnold Julie	Julie Arnold
Carli Julie	Julie Carli
Bertau Julien	Julien Bertau
Bertheau Julien	Julien Bertheau
Guiomar Julien	Julien Guiomar
Lacroix Julien	Julien Lacroix
Degenne Juliette	Juliette Degenne
Gréco Juliette	Juliette Gréco
Jérome Juliette	Juliette Jérome
Pacley Juliette	Juliette Pacley
Chabaga Karina	Karina Chabaga
Amaizo Katy	Katy Amaizo
Badie Laurence	Laurence Badie
Leauté Laurence	Laurence Leauté
Mercier Laurence	Laurence Mercier
Weber Laurence	Laurence Weber
Baffie Laurent	Laurent Baffie
Benegui Laurent	Laurent Benegui
Malet Léo	Léo Malet
Deutsch Léon	Léon Deutsch
Peillard Léonce	Léonce Peillard
Carolles Liliane	Liliane Carolles
Gaudet Liliane	Liliane Gaudet
Godet Liliane	Liliane Godet
Sorval Liliane	Liliane Sorval
Siou Lily	Lily Siou
Méloche Line	Line Méloche
Noro Line	Line Noro
Lemercier Linette	Linette Lemercier
Livane Lisa	Lisa Livane
Lemaire Lisette	Lisette Lemaire
Brabant Loïc	Loïc Brabant
Pichon Loïc	Loïc Pichon
Bellon Loleh	Loleh Bellon
Arbessier Louis	Louis Arbessier
Chavance Louis	Louis Chavance
Ducreux Louis	Louis Ducreux
Matabon Louis	Louis Matabon
Rognoni Louis	Louis Rognoni
Roubaud Louis	Louis Roubaud
Seigner Louis	Louis Seigner
Thomas Louis	Louis Thomas
Velle Louis	Louis Velle
Conte Louise	Louise Conte
Debrackel Louise	Louise Debrackel
Sylvie Louise	Louise Sylvie
Ritz Luc	Luc Ritz
Dolene Lucie	Lucie Dolene
Barjon Lucien	Lucien Barjon
Frégis Lucien	Lucien Frégis
Guervil Lucien	Lucien Guervil
Nat Lucien	Lucien Nat
Plaissy Lucien	Lucien Plaissy
Plessis Lucien	Lucien Plessis
Raimbourg Lucien	Lucien Raimbourg
Givry Lucienne	Lucienne Givry
Legrand Lucienne	Lucienne Legrand
Lemarchand Lucienne	Lucienne Lemarchand
Letondal Lucienne	Lucienne Letondal
Troka Lucienne	Lucienne Troka
Hols Ludmilla	Ludmilla Hols
Zaréna Lydia	Lydia Zaréna
Barbulée Madeleine	Madeleine Barbulée
Clervanne Madeleine	Madeleine Clervanne
Duret Madeleine	Madeleine Duret
Lambert Madeleine	Madeleine Lambert
Ozeray Madeleine	Madeleine Ozeray
Robinson Madeleine	Madeleine Robinson
Sola Madeleine	Madeleine Sola
Sylvain Madeleine	Madeleine Sylvain
Vimes Madeleine	Madeleine Vimes
Avril Mag	Mag Avril
Simon Maïa	Maïa Simon
Ribovska Malka	Malka Ribovska
Ribowska Malka	Malka Ribowska
Gourary Manuela	Manuela Gourary
Barthod Many	Many Barthod
Cassot Marc	Marc Cassot
Darnault Marc	Marc Darnault
Duret Marc	Marc Duret
Fayolle Marc	Marc Fayolle
Lamole Marc	Marc Lamole
Pheline Marc	Marc Pheline
André Marcel	Marcel André
Bozzuffi Marcel	Marcel Bozzuffi
Cariven Marcel	Marcel Cariven
Charvey Marcel	Marcel Charvey
Hauriac Marcel	Marcel Hauriac
Lestan Marcel	Marcel Lestan
Roma Marcel	Marcel Roma
Sicard Marcel	Marcel Sicard
Tristani Marcel	Marcel Tristani
Dornac Marcelle	Marcelle Dornac
Géniat Marcelle	Marcelle Géniat
Hainia Marcelle	Marcelle Hainia
Praince Marcelle	Marcelle Praince
Ranson Marcelle	Marcelle Ranson
Lion Margo	Margo Lion
Neville Margot	Margot Neville
Cassan Marguerite	Marguerite Cassan
Perrin Marguerite	Marguerite Perrin
Pierry Marguerite	Marguerite Pierry
Laborit Maria	Maria Laborit
Mauban Maria	Maria Mauban
Tamar Maria	Maria Tamar
Dubois Marie	Marie Dubois
Letourneur Marie	Marie Letourneur
Martine Marie	Marie Martine
Vouilloux Marie	Marie Vouilloux
Ropp Mario	Mario Ropp
Game Marion	Marion Game
Mercadier Marthe	Marthe Mercadier
Lewis Martin	Martin Lewis
Trévières Martin	Martin Trévières
Couture Martine	Martine Couture
Ferrière Martine	Martine Ferrière
Sarcey Martine	Martine Sarcey
Marie Martine-actrice	Martine-actrice Marie
Paillet Maryse	Maryse Paillet
Ortlieb Mathieu	Mathieu Ortlieb
Casadesus Mathilde	Mathilde Casadesus
Rayer Maud	Maud Rayer
Barnay Maurice	Maurice Barnay
Bastide Maurice	Maurice Bastide
Biraud Maurice	Maurice Biraud
Bourbon Maurice	Maurice Bourbon
Chevit Maurice	Maurice Chevit
Cury Maurice	Maurice Cury
Decraiene Maurice	Maurice Decraiene
Dekobra Maurice	Maurice Dekobra
Dorleac Maurice	Maurice Dorleac
Ellabert Maurice	Maurice Ellabert
Marrou Maurice	Maurice Marrou
Nasil Maurice	Maurice Nasil
Pierrat Maurice	Maurice Pierrat
Renard Maurice	Maurice Renard
Renault Maurice	Maurice Renault
Roland Maurice	Maurice Roland
Ronet Maurice	Maurice Ronet
Sarfati Maurice	Maurice Sarfati
Teynac Maurice	Maurice Teynac
Travail Maurice	Maurice Travail
Amyl Max	Max Amyl
Harry Max	Max Harry
Megy Max	Max Megy
Aubin Maxime	Maxime Aubin
Halliday Michael	Michael Halliday
Underwood Michael	Michael Underwood
Averlant Michel	Michel Averlant
Barbey Michel	Michel Barbey
Beaume Michel	Michel Beaume
Beaune Michel	Michel Beaune
Bouquet Michel	Michel Bouquet
Boy Michel	Michel Boy
Clainchy Michel	Michel Clainchy
Cousin Michel	Michel Cousin
Creton Michel	Michel Creton
Dodane Michel	Michel Dodane
Dumur Michel	Michel Dumur
Duplessis Michel	Michel Duplessis
Etcheverry Michel	Michel Etcheverry
Ferrand Michel	Michel Ferrand
Fiszbin Michel	Michel Fiszbin
Fizbin Michel	Michel Fizbin
Fustier Michel	Michel Fustier
Granvale Michel	Michel Granvale
Lebrun Michel	Michel Lebrun
Mery Michel	Michel Mery
Morano Michel	Michel Morano
Nastorg Michel	Michel Nastorg
Parier Michel	Michel Parier
Paulin Michel	Michel Paulin
Piccoli Michel	Michel Piccoli
Puterflam Michel	Michel Puterflam
Renault Michel	Michel Renault
Ruhl Michel	Michel Ruhl
Tureau Michel	Michel Tureau
Vigne Michel	Michel Vigne
Vitold Michel	Michel Vitold
Lituac Michèle	Michèle Lituac
Montel Michele	Michele Montel
Monti Michele	Michele Monti
Bona Micheline	Micheline Bona
Boudet Micheline	Micheline Boudet
Dupre Micheline	Micheline Dupre
Francey Micheline	Micheline Francey
Luccioni Micheline	Micheline Luccioni
Konkoly Miklos	Miklos Konkoly
Burton Miles	Miles Burton
Dol Mona	Mona Dol
Gérard Monique	Monique Gérard
Guerin Monique	Monique Guerin
Martial Monique	Monique Martial
Morisi Monique	Monique Morisi
Saintey Monique	Monique Saintey
Thierry Monique	Monique Thierry
Dalmès Mony	Mony Dalmès
Chaney Muriel	Muriel Chaney
Barentin Nadia	Nadia Barentin
Alari Nadine	Nadine Alari
Basile Nadine	Nadine Basile
Jadot Nathalie	Nathalie Jadot
Nerval Nathalie	Nathalie Nerval
Hawthorne Nathaniel	Nathaniel Hawthorne
Allard Nelly	Nelly Allard
Benedetti Nelly	Nelly Benedetti
Borgeaud Nelly	Nelly Borgeaud
Delmas Nelly	Nelly Delmas
Jonquille Népomucène	Népomucène Jonquille
Blake Nicholas	Nicholas Blake
Amato Nicolas	Nicolas Amato
Marie Nicolas	Nicolas Marie
Courcel Nicole	Nicole Courcel
Favart Nicole	Nicole Favart
Gueden Nicole	Nicole Gueden
Jamet Nicole	Nicole Jamet
Parrot Nicole	Nicole Parrot
Strauss Nicole	Nicole Strauss
Vervil Nicole	Nicole Vervil
Frank Nino	Nino Frank
Barbey Noël	Noël Barbey
Calef Noël	Noël Calef
Hussenot Noëlle	Noëlle Hussenot
Barrois Odette	Odette Barrois
Laure Odette	Odette Laure
Joris Olivier	Olivier Joris
Schisgal Oscar	Oscar Schisgal
Wilde Oscar	Oscar Wilde
Mazzotti Pascal	Pascal Mazzotti
Galbeau Patrice	Patrice Galbeau
Highsmith Patricia	Patricia Highsmith
Vilon Patricia	Patricia Vilon
Bancarel Patrick	Patrick Bancarel
Delhalle Patrick	Patrick Delhalle
Maurin Patrick	Patrick Maurin
Pessis Patrick	Patrick Pessis
Préjean Patrick	Patrick Préjean
Alexandre Paul	Paul Alexandre
Amiot Paul	Paul Amiot
Bourget Paul	Paul Bourget
Cambo Paul	Paul Cambo
Chevalier Paul	Paul Chevalier
Crauchet Paul	Paul Crauchet
Demange Paul	Paul Demange
Enteric Paul	Paul Enteric
Faivre Paul	Paul Faivre
Frankeur Paul	Paul Frankeur
Gérard Paul	Paul Gérard
Mulder Paul	Paul Mulder
Rieger Paul	Paul Rieger
Siraudin Paul	Paul Siraudin
Swam Paul	Paul Swam
Vandenberghe Paul	Paul Vandenberghe
Villé Paul	Paul Villé
Regier Paula	Paula Regier
Emanuèle Paule	Paule Emanuèle
Fainval Paule	Paule Fainval
Dubost Paulette	Paulette Dubost
Franck Paulette	Paulette Franck
Frantz Paulette	Paulette Frantz
Simonin Paulette	Paulette Simonin
Carton Pauline	Pauline Carton
Larrieu Pauline	Pauline Larrieu
Chauveau Philippe	Philippe Chauveau
Clay Philippe	Philippe Clay
Coypel Philippe	Philippe Coypel
Derrez Philippe	Philippe Derrez
Dumas Philippe	Philippe Dumas
Dumat Philippe	Philippe Dumat
Etesse Philippe	Philippe Etesse
Guinard Philippe	Philippe Guinard
Hébert Philippe	Philippe Hébert
Laudenbach Philippe	Philippe Laudenbach
Lemaire Philippe	Philippe Lemaire
Mareuil Philippe	Philippe Mareuil
Moreau Philippe	Philippe Moreau
Nahon Philippe	Philippe Nahon
Nicaud Philippe	Philippe Nicaud
Toury Philippe	Philippe Toury
Sorano Piella	Piella Sorano
Amel Pierre	Pierre Amel
Apesteguy Pierre	Pierre Apesteguy
Billard Pierre	Pierre Billard
Blanchard Pierre	Pierre Blanchard
Boileau Pierre	Pierre Boileau
Bonzans Pierre	Pierre Bonzans
Collet Pierre	Pierre Collet
Constant Pierre	Pierre Constant
Dac Pierre	Pierre Dac
Decazes Pierre	Pierre Decazes
Delbon Pierre	Pierre Delbon
Destailles Pierre	Pierre Destailles
Ferval Pierre	Pierre Ferval
Forquin Pierre	Pierre Forquin
Frachet Pierre	Pierre Frachet
Franck Pierre	Pierre Franck
Frenel Pierre	Pierre Frenel
Fresnay Pierre	Pierre Fresnay
Fromont Pierre	Pierre Fromont
Gallon Pierre	Pierre Gallon
Garin Pierre	Pierre Garin
Humbourg Pierre	Pierre Humbourg
Lafont Pierre	Pierre Lafont
Lamblin Pierre	Pierre Lamblin
Laroche Pierre	Pierre Laroche
Larquey Pierre	Pierre Larquey
Latour Pierre	Pierre Latour
Léaud Pierre	Pierre Léaud
Leproux Pierre	Pierre Leproux
Marteville Pierre	Pierre Marteville
Michael Pierre	Pierre Michael
Mirat Pierre	Pierre Mirat
Moncorbier Pierre	Pierre Moncorbier
Mondy Pierre	Pierre Mondy
Nord Pierre	Pierre Nord
Olaf Pierre	Pierre Olaf
Olivier Pierre	Pierre Olivier
Palau Pierre	Pierre Palau
Peloux Pierre	Pierre Peloux
Pernet Pierre	Pierre Pernet
Peyrou Pierre	Pierre Peyrou
Plessis Pierre	Pierre Plessis
Risch Pierre	Pierre Risch
Rolland Pierre	Pierre Rolland
Royer Pierre	Pierre Royer
Santini Pierre	Pierre Santini
Siniac Pierre	Pierre Siniac
Stephen Pierre	Pierre Stephen
Trabaud Pierre	Pierre Trabaud
Vaneck Pierre	Pierre Vaneck
Vernier Pierre	Pierre Vernier
Véry Pierre	Pierre Véry
Ville Pierre	Pierre Ville
Castan Pierrette	Pierrette Castan
Salik Rachel	Rachel Salik
Messac Ralph	Ralph Messac
Curet Raoul	Raoul Curet
Guillet Raoul	Raoul Guillet
Marco Raoul	Raoul Marco
Praxy Raoul	Raoul Praxy
Patorni Raphaël	Raphaël Patorni
Baillet Raymond	Raymond Baillet
Chandler Raymond	Raymond Chandler
Chilot Raymond	Raymond Chilot
Faure Raymond	Raymond Faure
Jourdan Raymond	Raymond Jourdan
Pelissier Raymond	Raymond Pelissier
Pellegrin Raymond	Raymond Pellegrin
Verney Raymonde	Raymonde Verney
Blaess Régine	Régine Blaess
Chantal Régine	Régine Chantal
Serva Régine	Régine Serva
Jauffret Régis	Régis Jauffret
Delage Rémy	Rémy Delage
Kirch Rémy	Rémy Kirch
Sibel Rémy	Rémy Sibel
Mary Renaud	Renaud Mary
Cambien René	René Cambien
Cardona René	René Cardona
Clermont René	René Clermont
Dary René	René Dary
Farabet René	René Farabet
Fleur René	René Fleur
Garcia René	René Garcia
Guillot René	René Guillot
Havard René	René Havard
Hiéronimus René	René Hiéronimus
Lefèvre René	René Lefèvre
Lemaire René	René Lemaire
Pascal René	René Pascal
Renaud René	René Renaud
Renot René	René Renot
Smith René	René Smith
Sussan René	René Sussan
Barell Renée	Renée Barell
Gardes Renée	Renée Gardes
Vernes Renée	Renée Vernes
Webb Richard	Richard Webb
Arnoux Robert	Robert Arnoux
Aubry Robert	Robert Aubry
Basil Robert	Robert Basil
Basile Robert	Robert Basile
Chandeau Robert	Robert Chandeau
Dadies Robert	Robert Dadies
Dalban Robert	Robert Dalban
Darame Robert	Robert Darame
Deslandes Robert	Robert Deslandes
Favart Robert	Robert Favart
Guilmet Robert	Robert Guilmet
Marcy Robert	Robert Marcy
Martin Robert	Robert Martin
Maufras Robert	Robert Maufras
Mercier Robert	Robert Mercier
Miller Robert	Robert Miller
Murzeau Robert	Robert Murzeau
Nahmias Robert	Robert Nahmias
Party Robert	Robert Party
Rollis Robert	Robert Rollis
Bret Roger	Roger Bret
Carel Roger	Roger Carel
Coggio Roger	Roger Coggio
Couderc Roger	Roger Couderc
Crouzet Roger	Roger Crouzet
Dathys Roger	Roger Dathys
Faller Roger	Roger Faller
Hanin Roger	Roger Hanin
Iglesis Roger	Roger Iglesis
Maridat Roger	Roger Maridat
Monclin Roger	Roger Monclin
Peyrou Roger	Roger Peyrou
Régent Roger	Roger Régent
Richard Roger	Roger Richard
Trecan Roger	Roger Trecan
Ménard Roland	Roland Ménard
Favey Rosine	Rosine Favey
Varte Rosy	Rosy Varte
Ravel Sabine	Sabine Ravel
Nair Savitri	Savitri Nair
Blumenthal Serge	Serge Blumenthal
Douay Serge	Serge Douay
Petrof Serge	Serge Petrof
Reggiani Serge	Serge Reggiani
Rousseau Serge	Serge Rousseau
Sauvion Serge	Serge Sauvion
Donati Sergio	Sergio Donati
Monfort Silvia	Silvia Monfort
Arbellot Simon	Simon Arbellot
Landry Simone	Simone Landry
Matil Simone	Simone Matil
Certain Solange	Solange Certain
Bouilloux Sophie	Sophie Bouilloux
Jeney Sophie	Sophie Jeney
Frattini Stéphane	Stéphane Frattini
Cely Suzanne	Suzanne Cely
Courtal Suzanne	Suzanne Courtal
Flon Suzanne	Suzanne Flon
Perel Suzanne	Suzanne Perel
Goffre Suzel	Suzel Goffre
Dornac Suzy	Suzy Dornac
Hannier Suzy	Suzy Hannier
Prim Suzy	Suzy Prim
Boue Swany	Swany Boue
Joubert Sylvain	Sylvain Joubert
Margolle Sylviane	Sylviane Margolle
Artel Sylvie	Sylvie Artel
Denis Sylvie	Sylvie Denis
Desilles Sylvie	Sylvie Desilles
Favre Sylvie	Sylvie Favre
Février Sylvie	Sylvie Février
Georges Sylvie	Sylvie Georges
Joly Sylvie	Sylvie Joly
Moreau Sylvie	Sylvie Moreau
Pelayo Sylvie	Sylvie Pelayo
Simon Sylvie	Sylvie Simon
Delannoy Sylvine	Sylvine Delannoy
Powell Talmage	Talmage Powell
Balachova Tania	Tania Balachova
Bilis Teddy	Teddy Bilis
Beccaro Thierry	Thierry Beccaro
Lefevre Thierry	Thierry Lefevre
Narcejac Thomas	Thomas Narcejac
Taffin Tony	Tony Taffin
Bernard Tristan	Tristan Bernard
Bonnier Valérie	Valérie Bonnier
Feyder Véra	Véra Feyder
Sudry Véronique	Véronique Sudry
Corot Vicky	Vicky Corot
Messica Vicky	Vicky Messica
Ropion Vincent	Vincent Ropion
Ledieu Virginie	Virginie Ledieu
Gosset Viviane	Viviane Gosset
Collins Wilkie	Wilkie Collins
Irish William	William Irish
Sabatier William	William Sabatier
Renoult Xavier	Xavier Renoult
Paranthoën Yann	Yann Paranthoën
Boisyvon Yannick	Yannick Boisyvon
Noé Yvan	Yvan Noé
Arcanel Yves	Yves Arcanel
Boisyvon Yves	Yves Boisyvon
Brainville Yves	Yves Brainville
Deniaud Yves	Yves Deniaud
Duchateau Yves	Yves Duchateau
Furet Yves	Yves Furet
Gladine Yves	Yves Gladine
Jamiaque Yves	Yves Jamiaque
Peneau Yves	Yves Peneau
Pignot Yves	Yves Pignot
Rénier Yves	Yves Rénier
Clech Yvonne	Yvonne Clech
Decade Yvonne	Yvonne Decade
Gaudeau Yvonne	Yvonne Gaudeau
Villeroy Yvonne	Yvonne Villeroy
Achard Marie Claire	Marie Claire Achard
Addington Symonds Francis	Francis Addington Symonds
Amato Jean Marie	Jean-Marie Amato
Arlaud Rodolphe Maurice	Rodolphe-Maurice Arlaud
Arnaud Georges Jean	Georges-Jean Arnaud
Aslanian Jean Jacques	Jean-Jacques Aslanian
Assia-chanteuse	Assia Maouène
Augier Marthe Anne	Marthe-Anne Augier
Baecker Raymond de	Raymond de Baecker
Balzac Honoré de	Honoré de Balzac
Beaupré Jacques de	Jacques de Beaupré
Bentley Edmund Clerihew	Edmund Clerihew Bentley
Bermat Jean Louis	Jean-Louis Bermat
Bernard Jean Pierre	Jean-Pierre Bernard
Bertaud Jean Paul	Jean-Paul Bertaud
Berthaud Jean Paul	Jean-Paul Bertaud
Blondeau Jacques Adrien	Jacques-Adrien Blondeau
Bomier Georges Gabriel	Georges-Gabriel Bomier
Botton Isabelle de	Isabelle de Botton
Bouillaud Jean Claude	Jean-Claude Bouillaud
Bramley Moore Zelma	Zelma Bramley Moore
Brandt Jane Lewis	Jane Lewis Brandt
Calvet Jean Louis	Louis-Jean Calvet
Calvé Jean François	Louis-Jean Calvet
Cassel Jean Pierre	Jean-Pierre Cassel
Caussimon Jean Roger	Jean-Roger Caussimon
Cervioni Louis Thomas	Louis Thomas Cervioni
Chauffard René Jacques	René-Jacques Chauffard
Clary Hugues G	Hugues G. Clary
Cluzeau Louis Michel	Louis-Michel Cluzeau
Coffinet Anne Marie	Anne-Marie Coffinet
Colas Jean Pierre	Jean-Pierre Colas
Conan Doyle Arthur	Arthur Conan Doyle
Conty Jean Pierre	Jean-Pierre Conty
Coquelin Jean Paul	Jean-Paul Coquelin
Daniel Norman Jacques	Jacques Daniel-Norman
Darras Jean Pierre	Jean-Pierre Darras
Daste Marie Hélène	Marie-Hélène Daste
Delbo Jean Jacques	Jean-Jacques Delbo
Demantes Jean Jacques	Jean-Jacques Demantes
Du Boisgobey Fortuné	Fortuné Du Boisgobey
Duprez Gilbert Maurice	Gilbert Maurice Duprez
Dutilh Jean Claude	Jean-Claude Dutilh
Duverney Anne Marie	Anne-Marie Duverney
Endrebe Maurice Bernard	Maurice-Bernard Endrèbe
Fabre Jacques Henri	Jacques-Henri Fabre
Ferrière Jean Pierre	Jean-Pierre Ferrière
Fertey Jean Marie	Jean-Marie Fertey
Ferté Jean Marie	Jean-Marie Fertey
Fonteneau Jean Marie	Jean-Marie Fonteneau
Fournas Rémi de	Rémi de Fournas
Funès Louis de	Louis de Funès
Fusier Gir Jeanne	Jeanne Fusier-Gir
Gaget Jean Luc	Jean-Luc Gaget
Gantzer Marie France	Marie-France Gantzer
Gardien Marie Jeanne	Marie-Jeanne Gardien
Garrett Jean Wilfrid	Jean-Wilfrid Garret
Gattey Charles Neilson	Charles Neilson Gattey
Goustine Luc de	Luc de Goustine
Grégoire Jean Albert	Jean-Albert Grégoire
Hoffmann Ernst Theodor	Ernst Theodor Amadeus Hoffmann
Horwitz Jean Louis	Jean-Louis Horwitz
Houdinière Jean Claude	Jean-Claude Houdinière
Jandeline	Jandeline
Jemma Jean Louis	Jean-Louis Jemma
Jolivet Pierre Alain	Pierre-Alain Jolivet
Josselin Jean François	Jean-François Josselin
Kayser Jean Luc	Jean-Luc Kayser
Kset Manuel de	Manuel de Kset
Lafforest Roger de	Roger de Lafforest
Lallemand Jean Claude	Jean-Claude Lallemand
Lanaut Christian de	Christian de Lanaut
Lapparent Hubert de	Hubert de Lapparent
Las Vergnas Raymond	Raymond Las Vergnas
Le Bail Françoise	Françoise Le Bail
Le Beal Robert	Robert Le Béal
Le Couey Catherine	Catherine Le Couey
Le Fol Anne	Anne Le Fol
Le Lann Marc	Marc Le Lann
Le Person Paul	Paul Le Person
Leroux Jean Pierre	Jean-Pierre Leroux
Lituac Jean Pierre	Jean-Pierre Lituac
Lorac Edith Caroline Rivett	Edith Caroline Rivett Lorac
Mac Avoy Dominique	Dominique Mac Avoy
Mac Cloy Helen	Helen Mac Cloy
Mac Orlan Pierre	Pierre Mac Orlan
Mainty Marie José	Marie-José Mainty
Marielle Jean Pierre	Jean-Pierre Marielle
Maurin Jean Pierre	Jean-Pierre Maurin
Maurin Yves Marie	Yves-Marie Maurin
Maury Jean Louis	Jean-Louis Maury
Michel Jean Claude	Jean-Claude Michel
Mineur Guy Pierre	Guy-Pierre Mineur
Moreau Jean Luc	Jean-Luc Moreau
Morin Jean Pierre	Jean-Pierre Morin
Morin Yves Marie	Yves-Marie Morin
Moulinot Jean Paul	Jean-Paul Moulinot
Nerval Gérard de	Gérard de Nerval
Nesi Marie Pascale	Marie-Pascale Nesi
Noyes Hart Frances	Frances Noyes Hart
Noël Jean Jacques	Jean-Jacques Noël
Orchestre lyrique de l'ORTF	Orchestre lyrique de l'ORTF
Pascal Jean Claude	Jean-Claude Pascal
Peumery Suzanne Edith	Suzanne Edith Peumery
Pham Van Ky	Pham Van Ky
Pillet Marie Thérèse	Marie-Thérèse Pillet
Poe Edgar Allan	Edgar Allan Poe
Porret Jean Luc	Jean-Luc Porret
Puente Pierre Henri	Pierre-Henri Puente
Richard Henri Charles	Henri-Charles Richard
Richepin Jean Paul	Jean-Paul Richepin
Rivage Gabriel de	Gabriel de Rivage
Rivière Marie France	Marie-France Rivière
Rochand Anne Marie	Anne-Marie Rochand
Rémi Jean François	Jean-François Rémi
Saint Bris Richard	Richard Saint-Bris
Saint Georges Henri	Henri Saint-Georges
Saint Sot Cathie	Cathie Saint-Sot
Steen Jean Jacques	Jean-Jacques Steen
Tamaris Jean Paul	Jean-Paul Tamaris
Terrex Jean Luc	Jean-Luc Terrex
Thibault Jean Charles	Jean-Charles Thibault
Tiémélé Jean Baptiste	Jean-Baptiste Tiémélé
Tobler Jean Marc	Jean-Marc Tobler
Trintignant Jean Louis	Jean-Louis Trintignant
Vallé Valdy Armand	Armand Vallé Valdy
Vergne Marie Blanche	Marie-Blanche Vergne
Vierne Jean Jacques	Jean-Jacques Vierne
Villiers de L'Isle Adam Auguste de	Adam Auguste de Villiers de L'Isle
Wartel Jean Pierre	Jean-Pierre Wartel
Yd Jean d'	Jean d'Yd
Zie Me Daniel	Daniel Zié-Mé
